X                         X
X                         X
X                         X
X        XXXXXXXXX        X
X                         X
X                         X
X E E                 E E X
XXXXXXX             XXXXXXX 
X                         X
X                         X
X          E   E          X
X        XXXXXXXXX        X
X            X            X
X            X            X
X         E  X  E     E   X
XXXXXXXXXXXXXXXXXXXXXXXXXXX